#S##################
#.#.DABCDABCDABCDAC#
#.#.CDABCDABCDABCDB#
#.#.BCDABCDABCDABCA#
#.#.ABCDABCDABCDABD#
#.#.DABCDABCDABCDAC#
#.#.CDABCDABCDABCDB#
#.#.BCDABCDABCDABCA#
#.#.ABCDABCDABCDABD#
#.#.############...#
#.#.#..............#
#.#.#.AAAAAAAAAAAAA#
#.#.#..............#
#.#.#BBBBBBBABBBBB.#
#.#.#..............#
#.#.#.CCCCCCCCCCACC#
#.#.#..............#
#...#DDDDDDDADDDDD.#
#.#.#..............#
##################E#